3333333333
3322222233
0022222200
1110000111
0303003030